{
  "grid": [
    "1111111111",
    "1S00000001",
    "1011111101",
    "1000000101",
    "1111110101",
    "1000000101",
    "1011111001",
    "1011111111",
    "10000000E1",
    "1111111111"
  ]
}
