{
  "grid": [
    "11111111111",
    "1S100000001",
    "10101111011",
    "10100001001",
    "10111101101",
    "10000001E01",
    "11101101111",
    "10000101101",
    "10111101001",
    "10000100011",
    "11111111111"
  ]
}
