{
  "grid": [
    "1111111111111111111",
    "1S00001000000000001",
    "1111101011111111101",
    "1000001000000000101",
    "1011111111111010101",
    "1000000000001010101",
    "1111111111101010101",
    "1000000000101010101",
    "1011111110101010101",
    "1010000010101010101",
    "1010111010101010101",
    "1010001010101010101",
    "1011101010101010101",
    "1000001000101010101",
    "1111111110101010101",
    "1000000000101010101",
    "1011111111101011101",
    "100000000000001E001",
    "1111111111111111111"
  ]
}
