{
  "grid": [
    "11111111111111111111111",
    "1S000010000000000000001",
    "11101011111111111111001",
    "10001000000000000001001",
    "10111111111111111001001",
    "10100000000000001001001",
    "10101111111111101001001",
    "10100000000000101001001",
    "10111111111110101001001",
    "10000000000010101001001",
    "11111111111010101001001",
    "10000000001010101001001",
    "10111111101010101001001",
    "10100000101010101001001",
    "10101110101010101001001",
    "10100010101010101001001",
    "10111010101010101001001",
    "10000010100000100001001",
    "11111110111110111111001",
    "10000000011111111111111",
    "10111111000110000110001",
    "100000000100001100001E1",
    "11111111111111111111111"
  ]
}
